wwwwwwwwwwwwwww
w   -------   w
w w-w-w-w-w-w w
w-w-w-w-w-w-w-w
w-w-w-w-w-w-w-w
w-w-w-w-w-w-w-w
w-w-w-w-w-w-w-w
w-w-w-w-w-w-w-w
w-w-w-w-w-w-w-w
w-w-w-w-w-w-w-w
w w-w-w-w-w-w w
w   -------   w
wwwwwwwwwwwwwww